31 11 31 11 31 11 31 11 31 11 31 11 31 11 31 11 31 11 31 11 31 11 31 11 31
21 00 20 00 21 00 20 00 21 00 20 00 20 00 20 00 20 00 20 00 21 00 20 00 21
31 11 31 10 31 10 31 10 31 10 31 10 31 11 31 11 31 11 31 10 31 11 31 10 31
21 00 20 00 21 00 21 00 21 00 21 00 20 00 20 00 20 00 21 00 20 00 20 00 21
31 10 31 10 31 10 31 10 31 11 31 10 30 10 31 10 31 11 31 11 31 10 31 11 31
21 00 21 00 21 00 21 00 21 00 20 00 20 00 21 00 20 00 20 00 20 00 21 00 21
31 10 31 10 31 10 31 10 31 10 30 10 31 10 31 10 31 11 31 11 31 11 31 10 31
21 00 21 00 21 00 21 00 21 00 20 00 21 00 21 00 21 00 20 00 21 00 20 00 21
31 10 31 11 31 10 31 10 31 10 30 10 31 11 31 10 31 10 30 10 31 10 31 10 31
21 00 20 00 20 00 21 00 20 00 20 00 21 00 20 00 20 00 20 00 21 00 21 00 21
31 10 31 10 30 10 31 11 31 11 31 10 31 11 31 11 31 11 31 10 31 10 31 10 31
21 00 21 00 20 00 21 00 20 00 20 00 20 00 20 00 20 00 20 00 21 00 21 00 21
31 11 31 11 31 11 31 10 30 10 31 11 31 11 31 11 31 11 31 11 31 10 31 10 31
21 00 20 00 20 00 20 00 20 00 21 00 20 00 20 00 20 00 20 00 20 00 21 00 21
31 11 31 11 31 11 31 11 31 11 31 11 31 11 31 11 31 11 31 11 31 11 31 11 31
#
cell_floor index = 00
wall_floor_vert index = 10
wall_vert index = 11
wall_floor_hor index = 20
wall_hor index = 21
square index = 31
